1111111111111111
1001000000100011
1000011110101011
1P0000C000000E11
1111111111111111