11111111111111111111111111
10010000000C0000001C100011
10000111110111011110101011
1P0011C0000011000000001E11
11111111111111111111111111