11111111
110C00C1
1E000001
1P000001
100000E1
11111111