1111111111111111
1T010000001000C1
1000010110101011
1010010110101001
111001011T101011
100001C110101001
1011111110101101
1P0000C0000000E1
1111111111111111