11111111111
1111111101
111111111
