11111111
11000001
1E000001
10000001
1P000001
10000001
1E000001
1C000001
1E000001
100000E1
11111111